a / an	неопределённый артикль (a/an)
abandon	отказаться от
ability	способность
able	способный; в состоянии
about	о
above	выше
abroad	за рубежом
absolute	абсолютное
absolutely	абсолютно
academic	академический
accept	принять
acceptable	хорошо
access	доступ к
accident	авария
accompany	сопровождать
according to	согласно
account	учетная запись
accurate	точная
accuse	обвинять
achieve	достижения
achievement	достижения
acknowledge	признать
acquire	приобрести
across	по всей
act	акт
action	действия
active	активные
activity	деятельность
actor	актер
actress	актриса
actual	фактические
actually	на самом деле
ad	объявление
adapt	адаптировать
add	добавить
addition	дополнение
additional	дополнительные
address	адрес
administration	администрация; управление
admire	полюбоваться
admit	признать
adopt	принять
adult	взрослый
advance	заранее
advanced	расширенный
advantage	преимущества
adventure	приключения
advertise	рекламировать
advertisement	реклама
advertising	реклама
advice	советы
advise	консультировать
affair	дело
affect	влияют на
afford	позволить себе
afraid	бояться
after	после
afternoon	после обеда
afterward	впоследствии
again	снова
against	против
age	возраст
agency	агентство
agenda	повестка дня
agent	агент
aggressive	агрессивный
ago	назад
agree	согласен
agreement	соглашение
ah	ах; а
ahead	впереди
aid	помощь
aim	цель
air	воздуха
aircraft	самолеты
airline	авиакомпания
airport	аэропорт
alarm	будильник
album	альбом
alcohol	алкоголь
alcoholic	алкогольные
alive	жив
all	все
all right	хорошо
allow	разрешить
almost	почти
alone	только
along	вдоль
already	уже
also	также
alter	изменить
alternative	альтернатива
although	хотя
always	всегда
amazed	поразило
amazing	удивительный
ambition	амбиции
among	среди
amount	сумма
analysis	анализ
analyze	анализ
ancient	древние
and	и
anger	гнев
angle	угол
angry	злой
animal	животное
ankle	лодыжки
anniversary	юбилей
announce	объявить
announcement	объявление; анонс
annoy	раздражать
annoyed	раздражает
annoying	раздражает
annual	ежегодная
another	другой
answer	ответ
anxious	тревожно
any	любой
anybody	кто-нибудь
anymore	больше (не); больше уже
anyone	кто-нибудь
anything	что-нибудь
anyway	во всяком случае
anywhere	где угодно
apart	помимо
apartment	квартира
apologize	прошу прощения
app	приложение
apparent	ясно
apparently	по-видимому
appeal	обращение
appear	появляются
appearance	внешний вид
apple	яблоко
application	применение
apply	применить
appointment	назначение
appreciate	оценить
approach	подход
appropriate	соответствующие
approval	утверждение
approve	утвердить
approximately	примерно
April	апрель
architect	архитектор
architecture	архитектура
area	площадь
argue	спорить
argument	аргумент
arise	возникают
arm	рука
armed	вооруженные
arms	оружие
army	армия
around	вокруг
arrange	организовать
arrangement	композиция
arrest	арест
arrival	прибытие
arrive	прибытие
art	искусство
article	статьи
artificial	искусственные
artist	художник
artistic	художественные
as	как
ashamed	стыдно
aside	в сторону
ask	спросите
asleep	спит
aspect	аспект
assess	оценивать
assessment	оценка; оценивание
assignment	задание; назначение
assist	помощь
assistant	помощник
associate	юрист
associated	связанные
association	ассоциация
assume	предположим
at	в
athlete	спортсмен; атлет
atmosphere	атмосфера
attach	прикрепить
attack	атака
attempt	попытка
attend	участие
attention	внимание
attitude	отношение
attorney	адвокат
attract	привлечение
attraction	привлечение
attractive	привлекательный
audience	аудитория
August	август
aunt	тетя
author	автор
authority	орган
automatic	автоматически
automatically	автоматически
available	доступно
average	среднее
avoid	избегайте
award	премия
aware	учитывая
away	от отеля
awesome	потрясающий; классный
awful	ужасно
baby	детские
back	назад
background	справочная информация
backward	назад
bacteria	бактерии
bad	плохо
badly	плохо
bag	сумка
bake	выпекать
balance	баланс
ball	мяч
ban	запрет
banana	банан
band	группа
bank (money)	банк
bank (river)	берег (реки)
bar	бар
barrier	барьер
base	база
baseball	бейсбол
based	на основе
basic	основные
basically	в основном
basis	основы
basketball	баскетбол
bath	ванна
bathroom	ванная комната
battery	батарея
battle	битва
be	быть
beach	пляж
bean	фасоль; боб
bear (deal with)	терпеть; справляться (с)
bear (animal)	медведь
beat	бить
beautiful	красивая
beauty	салон красоты
because	потому что
become	стать
bed	кровати
bedroom	спальня
bee	пчела
beef	говядина
beer	пиво
before	перед
beg	умолять; просить
begin	начать
beginning	начало
behave	ведут себя
behavior	поведение
behind	позади
being	существо; бытие
belief	вера
believe	верить
bell	белл
belong	принадлежат
below	ниже
belt	пояса
bend	изгиб
benefit	преимущества
bent	бент
best	лучшие
bet	ставка
better	лучше
between	между
beyond	за пределами
bicycle	велосипедов
big	большой
bike	велосипед
bill	билл
billion	миллиард
biology	биология
bird	птица
birth	рождение
birthday	день рождения
bit	бит
bite	укус
bitter	горький
black	черный
blame	вину
blank	пустой
blind	слепой
block	блок
blog	блог
blond	блондин; светловолосый
blood	кровь
blow	удар
blue	голубой
board	совет
boat	лодка
body	тело
boil	кипения
bomb	бомба
bond	связь; облигация
bone	кость
book	книга
boot	загрузки
border	граница
bored	скучно
boring	скучно
born	родился
borrow	брать
boss	босс
both	оба
bother	беспокоить
bottle	бутылка
bottom	внизу
bowl	чаша
box	коробка
boy	мальчик
boyfriend	бойфренд
brain	мозг
branch	филиал
brand	бренд
brave	храбрый
bread	хлеб
break	перерыв
breakfast	завтрак
breast	грудь
breath	дыхание
breathe	дышать
breathing	дыхание
bride	невеста
bridge	мост
brief	краткий
bright	яркий
brilliant	блестящий
bring	принесите
broad	широкий
broadcast	трансляция
broken	сломанный
brother	брат
brown	коричневый
brush	кисть
bubble	пузырь
budget	бюджет
build	построить
building	здание
bullet	пуля
bunch	букет
burn	записать
bury	похоронить
bus	автобус
bush	буш
business	бизнес
businessman	бизнесмен
busy	занят
but	но
butter	сливочное масло
button	кнопка
buy	купить
by	по
bye	пока
cable	кабель
cafe	кафе
cake	торт
calculate	вычислить
call	вызов
calm	спокойствие
camera	камеры
camp	лагерь
campaign	кампания
camping	кемпинг
campus	кампус; университетский городок
can1	мочь; уметь
can2	банка (жестяная); консервная банка
cancel	отмена
cancer	рак
candidate	кандидат
candy	конфеты
cannot	не удается
cap	колпачок
capable	способных
capacity	емкость
capital	столица
captain	капитан
capture	захват
car	автомобиль
card	карта
care	уход
career	карьера
careful	тщательно
carefully	тщательно
careless	небрежно
carpet	ковер
carrot	морковь
carry	нести
cartoon	мультфильм; карикатура
case	дело
cash	наличные
cast	ролях
cat	кошка
catch	поймать
category	категория
cause	причина
CD	КОМПАКТ-ДИСК
ceiling	потолок
celebrate	отпраздновать
celebration	празднование
celebrity	знаменитость
cell	ячейка
cent	%
center	центр
central	центральный
century	века
ceremony	церемония
certain	некоторые
certainly	конечно
chain	цепь
chair	кресло
chairman	председатель
challenge	вызов
champion	чемпион
chance	шанс
change	изменить
channel	канал
chapter	глава
character	персонаж
characteristic	характеристика
charge	заряд
charity	благотворительность
chart	диаграмма
chat	чат
cheap	дешевые
cheat	чит
check	проверить
cheerful	веселый
cheese	сыр
chef	шеф-повар
chemical	химическая
chemistry	химия
chest	грудь
chicken	курица
chief	начальник
child	ребенок
childhood	детство
chip	чип
chocolate	шоколад
choice	выбор
choose	выбрать
church	церковь
cigarette	сигареты
circle	круг
circumstance	обстоятельство
cite	цитировать; ссылаться
citizen	гражданин
city	город
civil	гражданское
claim	претензии
class	класс
classic	классик
classical	классический
classroom	классная
clause	пункт (договора); придаточное предложение
clean	очистить
clear	очистить
clearly	ясно
clerk	клерк
clever	умный
click	нажмите кнопку
client	клиент
climate	климат
climb	восхождение
clock	будильник
close1	закрывать; закрыться
close2	близкий; тесный
closed	закрыто
closely	внимательно
closet	шкаф
cloth	ткань
clothes	одежда
clothing	одежда
cloud	облако
club	клуб
clue	подсказка; улика
coach	тренер
coal	уголь
coast	побережье
coat	пальто
code	код
coffee	кофе
coin	монета
cold	холодная
collapse	свернуть
colleague	коллега
collect	сбор
collection	коллекция
college	колледж
color	цвет
colored	цветной; окрашенный
column	колонка
combination	комбинация
combine	комбинат
come	прийти
comedy	комедия
comfort	комфорт
comfortable	удобный
command	команда
comment	комментарий
commercial	коммерческие
commission	комиссия
commit	фиксации
commitment	обязательство
committee	комитет
common	общие
commonly	обычно
communicate	общаться
communication	коммуникации
community	сообщество
company	компания
compare	сравнить
comparison	сравнение
compete	соревноваться
competition	конкурс
competitive	конкурентных
competitor	конкурент; участник соревнования
complain	пожаловаться
complaint	жалоба
complete	завершить
completely	полностью
complex	комплекс
complicated	сложные
component	компонент; составная часть
computer	компьютер
concentrate	концентрат
concentration	концентрация
concept	концепция
concern	беспокойство
concerned	заинтересованные
concert	концерт
conclude	заключение
conclusion	заключение
condition	состояние
conduct	поведения
conference	конференция
confidence	доверие
confident	уверенно
confirm	подтвердите
conflict	конфликт
confuse	путать
confused	путать
confusing	заблуждение
congress	конгресс
connect	подключение
connected	подключен
connection	подключение
conscious	сознавая
consequence	последствие
conservative	консервативная(ый)
consider	рассмотрим
consideration	рассмотрение
consist	состоят
consistent	последовательный; согласующийся
constant	константа
constantly	постоянно
construct	конструкция
construction	строительство
consume	потреблять
consumer	потребитель
contact	контакт
contain	содержат
container	контейнер
contemporary	современный
content1	довольный; удовлетворённый
contest	конкурс
context	контекст
continent	континент
continue	продолжить
continuous	непрерывный
contract	контракт
contrast	контраст
contribute	способствовать
contribution	вклад
control	управления
convenient	удобный
conversation	разговор
convert	конвертировать
convince	убедить
convinced	убеждённый
cook	кук
cookie	печенье
cooking	приготовление пищи
cool	классно
copy	копия
core	ядро
corn	кукуруза
corner	угол
corporate	корпоративный
correct	правильно
correctly	правильно
cost	стоимость
costume	костюм
cotton	хлопок
could	может
council	совет
count	количество
country	страна
countryside	сельской местности
county	уезд
couple	пара
courage	мужество
course	курс
court	суд
cousin	двоюродный брат
cover	обложка
covered	покрыты
cow	корова
crash	аварии
crazy	сумасшедший
cream	крем
create	создать
creation	создание; творение
creative	творческий
creature	существо
credit	кредит
crew	экипаж; команда
crime	преступность
criminal	уголовное
crisis	кризис
criterion	критерий
critic	критик
critical	критический
criticism	критика
criticize	критиковать
crop	урожай
cross	крест
crowd	толпа
crowded	переполненный
crucial	решающее значение
cruel	жестокие
cry	крик
cultural	культурные
culture	культура
cup	кубок
cupboard	шкаф
cure	лечение
curly	вьющиеся
currency	валюта
current	текущий
currently	в настоящее время
curtain	занавес
curve	кривая
curved	изогнутые
custom	пользовательские
customer	клиент
cut	вырезать
cycle	цикл
dad	папа
daily	ежедневно
damage	повреждения
dance	танец
dancer	танцовщица
dancing	танцы
danger	опасность
dangerous	опасный
dark	темный
data	данные
date	дата
daughter	дочь
day	день
dead	мертвых
deal	сделка
dear	дорогой
death	смерть
debate	дебаты
debt	задолженность
decade	десятилетие
December	декабрь
decent	приличный; достойный
decide	решение
decision	решение
declare	объявления
decline	снижение
decorate	украсить
decoration	украшения
decrease	уменьшение
deep	глубокое
deeply	глубоко
defeat	поражение
defend	защитить
defense	обороны
define	определить
definite	определенное
definitely	определенно
definition	определение
degree	степень
delay	задержка
deliberate	умышленное
deliberately	намеренно
delicious	вкусный
deliver	доставить
delivery	доставки
demand	спрос
demonstrate	демонстрации
dentist	стоматолог
deny	отрицать
department	кафедра
departure	отъезд
depend	зависит от
depressed	депрессия
depressing	удручает
depth	глубина
describe	опишите
description	описание
desert	пустыня
deserve	заслуживают
design	дизайн
designer	дизайнер
desire	желание
desk	стол
desperate	отчаянные
despite	несмотря на
dessert	десерт
destination	пункт назначения
destroy	уничтожить
detail	деталь
detailed	подробные
detect	обнаруживать
detective	детектив (сыщик)
determine	определить
determined	определяется
develop	разработка
development	развития
device	устройство
diagram	диаграмма
dialogue	диалог
diamond	алмаз
diary	дневник
dictionary	словарь
die	умереть
diet	диета
difference	разница
different	разные
differently	по-разному
difficult	трудно
difficulty	трудности
dig	копать
digital	цифровые
dinner	ужин
direct	прямой
direction	направление
directly	прямо
director	директор
dirt	грязь
dirty	грязные
disadvantage	недостаток
disagree	не согласен
disappear	исчезают
disappointed	разочарование
disappointing	разочарование
disaster	катастрофы
discipline	дисциплины
discount	скидка
discover	откройте для себя
discovery	открытие
discuss	обсудить
discussion	обсуждение
disease	болезнь
dish	блюдо
dishonest	нечестно
disk	диск
dislike	не нравится
dismiss	уволить
display	дисплей
distance	расстояние
distribute	распространение
distribution	распределение
district	район
divide	разделить
division	отдел
divorced	развелись
do1	делать
doctor	доктор
document	документ
documentary	документальный фильм
dog	собака
dollar	доллар
domestic	внутренние
dominate	доминируют
donate	жертвовать; делать пожертвование
door	двери
double	двухместный
doubt	сомнения
down	вниз
download	скачивать; загрузка
downstairs	на первом этаже
downtown	центр города
downward	вниз
dozen	дюжина
draft	проект
drag	перетащите
drama	драма
dramatic	драматический
draw	ничья
drawing	рисование
dream	мечта
dress	платье
dressed	одетый
drink	напиток
drive	привод
driver	драйвер
driving	вождение
drop	падение
drug	препарат
drum	барабан
drunk	пьяные
dry	сухой
due	из-за
during	во время
dust	пыль
duty	долг
DVD	DVD
each	каждый
ear	ухо
early	в начале
earn	заработать
earth	земля
earthquake	землетрясение
easily	легко
east	восток
eastern	восточная
easy	легко
eat	съесть
economic	экономические
economy	экономика
edge	край
edit	редактировать; монтаж
edition	издание
editor	редактор
educate	образование
educated	образование
education	образование
educational	образовательный; учебный
effect	эффект
effective	эффективное
effectively	эффективно
efficient	эффективное
effort	усилия
egg	яйцо
eight	восемь
eighteen	восемнадцать
eighty	восьмидесяти
either	либо
elderly	пожилые люди
elect	избрать
election	выборы
electric	электрические
electrical	электрические
electricity	электричество
electronic	электронные
element	элемент
elephant	слон
elevator	лифт
eleven	одиннадцать
else	остальное
elsewhere	где-нибудь ещё
email	отправить по электронной почте
embarrassed	смущенный
embarrassing	неловкое
emerge	выйти
emergency	чрезвычайная
emotion	эмоции
emotional	эмоциональное
emphasis	акцент
emphasize	подчеркнуть
employ	использовать
employee	сотрудник
employer	работодатель
employment	занятость
empty	пустая
enable	включить
encounter	встреча
encourage	поощрять
end	конец
ending	окончание
enemy	враг
energy	энергия
engage	участвовать
engaged	участие
engine	двигатель
engineer	инженер
engineering	инжиниринг
enhance	улучшать; усиливать
enjoy	наслаждайтесь
enormous	огромные
enough	достаточно
ensure	обеспечить
enter	введите
entertain	развлекать
entertainment	развлечения
enthusiasm	энтузиазм
enthusiastic	энтузиазм
entire	весь
entirely	полностью
entrance	вход; вступление
entry	вход
environment	окружающая среда
environmental	окружающей среды
episode	эпизод; серия
equal	равно
equally	не менее
equipment	оборудование
error	ошибка
escape	побег
especially	особенно
essay	эссе
essential	основные
establish	создать
estate	недвижимость
estimate	оценить
ethical	этический; нравственный
euro	евро
evaluate	оценивать
even	даже
evening	вечер
event	события
eventually	в конце концов
ever	когда-либо
every	каждый
everybody	все
everyday	повседневный
everyone	каждый
everything	все
everywhere	везде
evidence	свидетельства
evil	зло
exact	точное
exactly	совершенно верно
exam	экзамен
examination	экспертиза
examine	изучить
example	пример
excellent	отлично
except	за исключением
exchange	обмен
excited	возбужденных
excitement	волнение
exciting	захватывающие
excuse	извините
executive	исполнительный
exercise	упражнение
exhibit	выставка
exhibition	выставка
exist	существует
existence	существование
exit	выход
expand	разверните узел
expect	ожидать
expectation	ожидание
expected	ожидается
expense	расходы
expensive	дорогой
experience	опыт работы
experienced	опыт
experiment	эксперимент
expert	эксперт
explain	объяснить
explanation	объяснение
explode	взорваться
exploration	исследование
explore	исследовать
explosion	взрыв
export	экспорт
expose	разоблачение
express	экспресс
expression	выражение
extend	расширить
extent	степень
external	внешний
extra	дополнительные
extraordinary	чрезвычайный
extreme	экстрим
extremely	чрезвычайно
eye	глаз
face	лицо
facility	фонд
fact	факт
factor	фактор
factory	фабрика
fail	сбой
failure	провал
fair	ярмарка
fairly	довольно
faith	вера
fall	осень
false	значение false
familiar	знакомые
family	семья
famous	знаменитый
fan	вентилятор
fancy	фантазии
fantastic	фантастический; отличный
far	пока что
farm	ферма
farmer	фермер
farming	сельское хозяйство
fascinating	увлекательный; захватывающий
fashion	моды
fashionable	модная
fast	быстрый
fasten	закрепите
fat	жир
father	отец
fault	вина
favor	пользу
favorite	любимый
fear	страх
feather	перо
feature	функция
February	февраль
federal	федеральное
fee	плата
feed	корма
feedback	обратная связь; отзыв
feel	чувствовать себя
feeling	чувство
fellow	научный сотрудник
female	девушки
fence	забор
festival	фестиваль
fever	лихорадка
few	несколько
fiction	художественная литература; вымысел
field	поле
fifteen	пятнадцать
fifth	пятый
fifty	пятьдесят
fight	бой
fighting	боевые действия
figure	рисунок
file	файл
fill	заливка
film	фильм
final	окончательное
finally	и наконец
finance	финансы
financial	финансовые
find	найти
finding	находка; вывод (результат)
fine	штраф
finger	палец
finish	отделка
fire	огонь
firm	фирма
first	первый
fish	рыба
fishing	рыбалка
fit	покрой
fitness	физическая форма; фитнес
five	пять
fix	исправление
fixed	исправлено
flag	флаг
flame	пламя
flash	флэш
flat	квартира
flexible	гибкий
flight	рейс
float	поплавок
flood	наводнение
floor	этаж
flour	муки
flow	поток
flower	цветок
flu	грипп
fly	муха
flying	полет
focus	фокус
fold	сложите
folding	складные
folk	народный; люди
follow	следуйте
following	следующие
food	питание
foot	футов
football	футбол
for	для
force	силы
foreign	иностранные
forest	лес
forever	навсегда
forget	забыли
forgive	простить
fork	вилка
form	форма
formal	официальное
former	бывший
fortunately	к счастью
fortune	фортуна
forty	сорока
forward	вперед
found	найдено
four	четыре
fourteen	четырнадцать
fourth	четвертый
frame	кадр
free	бесплатно
freedom	свобода
freeze	замораживание
frequency	частота
frequently	часто
fresh	свежий
Friday	пятница
friend	друг
friendly	дружественные
friendship	дружба
frighten	пугают
frightened	пугало
frightening	страшно
frog	лягушка
from	от
front	фронт
frozen	замороженные
fruit	фрукты
fry	фрай
fuel	топливо
full	полный
fully	полностью
fun	развлечения
function	функция
fund	фонд
fundamental	основные
funding	финансирование
funny	смешно
fur	мех
furniture	мебель
further	далее
furthermore	кроме того; более того
future	будущее
gain	получить
gallery	галерея
game	игра
gang	банда; группировка
gap	разрыв
garage	гараж
garbage	мусор
garden	сад
gas	газ
gate	ворота
gather	сбор
general	общие
generally	как правило
generate	генерировать
generation	поколение
generous	щедрые
genre	жанр
gentle	нежный
gentleman	джентльмен
geography	география
get	получить
ghost	призрак
giant	гигант
gift	подарок
girl	девочка
girlfriend	подруга
give	дать
glad	рад
glass	стекло
global	глобальные
glove	перчатки
go	перейти
goal	цель
god	бог
gold	золото
golf	гольф
good	хорошее
goodbye	до свидания
goods	товары
govern	регулируют
government	правительство
governor	губернатор
grab	захватить
grade	класс
gradually	постепенно
graduate	выпускник; выпускаться
grain	зерно
grand	гранд
grandfather	дед
grandmother	бабушка
grandparent	дедушка
grant	грант
grass	трава
grateful	благодарность
gray	серый
great	прекрасно
green	грин
greet	приветствовать
grocery	бакалея
ground	земля
group	группа
grow	расти
growth	рост
guarantee	гарантия
guard	охранник
guess	угадай
guest	гость
guide	путеводитель
guilty	виновным
guitar	гитара
gun	пистолет
guy	гай
gym	спортзал
habit	привычка
hair	волосы
half	половина
hall	холл
hand	рука
handle	ручка
hang	зависание
happen	произойдет
happily	к счастью
happiness	счастье
happy	счастливый
hard	жесткий
hardly	вряд ли
harm	вреда
harmful	вредных
hat	шляпа
hate	ненавижу
have	у
have to	должен
he	он
head	руководитель
headache	головная боль
headline	заголовок (новости)
health	здравоохранение
healthy	здоровые
hear	слышать
hearing	слух
heart	сердце
heat	жара
heating	отопление
heaven	небеса
heavily	сильно
heavy	тяжелые
heel	каблук
height	высота
helicopter	вертолёт
hell	ада
hello	привет
help	справка
helpful	полезно
her	ее
here	здесь
hero	герой
hers	у нее
herself	сама
hesitate	колебаний
hey	эй; привет
hi	привет
hide	скрыть
high	высокая
highlight	голы
highly	очень
highway	шоссе
hill	хилл
him	его
himself	сам
hire	аренда
his	его
historic	исторический (значимый)
historical	исторические
history	история
hit	хит
hobby	хобби
hockey	хоккей
hold	удерживайте
hole	отверстие
holiday	праздник
hollow	пустотелые
holy	святой
home	домашняя страница
homework	домашнее задание
honest	серъёзная(ый)
honor	честь
hope	надежда
horrible	ужасный
horror	ужас
horse	лошадь
hospital	больница
host	хост
hot	горячие
hotel	отель
hour	стойка
house	дом
household	домашнее хозяйство
housing	жилье
how	как
however	однако
huge	огромные
human	человека
humor	юмор
humorous	с чувством юмора
hundred	сто
hungry	голодные
hunt	хант
hunting	охота
hurricane	ураган
hurry	спешите
hurt	больно
husband	муж
I	Я
ice	лед
ice cream	мороженое
idea	идея
ideal	идеальное
identify	определить
identity	личность
if	если
ignore	игнорировать
ill	плохо
illegal	незаконных
illness	болезни
illustrate	иллюстрации
illustration	иллюстрация
image	изображение
imaginary	мнимой
imagination	воображение
imagine	представьте себе
immediate	немедленно
immediately	немедленно
immigrant	иммигрант
impact	влияние
impatient	нетерпение
imply	подразумевает
import	импорт
importance	значение
important	важные
impose	навязать
impossible	невозможно
impress	впечатление
impressed	впечатление
impression	впечатление
impressive	впечатляющие
improve	улучшить
improvement	улучшение
in	в
inch	дюйм
incident	инцидент
include	включить
included	включённый; входящий в состав
including	включая
income	доход
increase	увеличить
increasingly	все больше и больше
incredible	невероятный
incredibly	невероятно; чрезвычайно
indeed	действительно
independent	независимая
indicate	укажите
indirect	косвенные
individual	индивидуальные
indoor	крытый
indoors	в помещении
industrial	промышленные
industry	промышленность
infection	инфекции
influence	влияние
inform	сообщить
informal	неофициальные
information	информация
ingredient	ингредиент
initial	первоначальный
initially	первоначально
initiative	инициатива
injure	повредить
injured	ранены
injury	травмы
inner	внутренний
innocent	невинный
inquiry	запрос; расследование
insect	насекомое
inside	внутри
insight	понимание; инсайт
insist	настаивать на том
inspire	вдохновлять
install	установка
instance	экземпляр
instead	вместо этого
institute	институт
institution	учреждение
instruction	инструкция
instructor	инструктор; преподаватель
instrument	инструмент
insurance	страхование
intelligence	интеллект
intelligent	интеллигентая(ый)
intend	намерены
intended	предназначен
intense	интенсивный; напряжённый
intention	намерение
interest	интерес
interested	заинтересованные
interesting	интересно
internal	внутренние
international	международные
internet	интернет
interpret	интерпретировать
interrupt	прерывание
interview	интервью
into	в
introduce	ввести
introduction	введение
invent	изобретать
invention	изобретение
invest	инвест
investigate	расследования
investigation	расследование
investment	инвестиции
invitation	приглашение
invite	пригласить
involve	включать
involved	участие
iron	утюг
island	остров
issue	выпуск
IT	ИТ; информационные технологии
it	это
item	элемент
its	его
itself	сам
jacket	куртка
jam	джем
January	январь
jazz	джаз
jeans	джинсы
jewelry	ювелирные изделия; украшения
job	работа
join	присоединиться
joke	шутка
journal	журнал; дневник
journalist	журналист
journey	путешествие
joy	джой
judge	судья
judgment	суждение; решение суда
juice	сок
July	июль
jump	прыжок
June	июнь
junior	полулюкс
just	просто
justice	правосудие
justify	оправдать
keep	сохранить
key	ключ
keyboard	клавиатура
kick	удар
kid	детские
kill	убить
killing	убийство
kilometer	километр
kind (type)	вид; тип
kind (caring)	добрый; заботливый
king	кинг
kiss	поцелуй
kitchen	кухня
knee	колено
knife	нож
knock	стук
know	знать
knowledge	знания
lab	лаборатория
label	лейбл
labor	труда
laboratory	лаборатория
lack	отсутствие
lady	леди
lake	озеро
lamp	лампа
land	земля
landscape	пейзаж
language	язык
laptop	ноутбук
large	большие
largely	значительной степени
last1 (final)	последний
last1 (taking time)	длиться
late	в конце
later	позже
latest	последние
laugh	смеяться
laughter	смех
launch	запуск
law	закон
lawyer	юрист
lay	заложить
layer	слой
lazy	ленивый
lead1	вести; руководить
leader	лидер
leadership	лидерство; руководство
leading	ведущий; передовой
leaf	лист
league	лига
lean	худой
learn	узнайте
learning	обучение; учёба
least	наименее
leather	кожа
leave	отпуск
lecture	лекция
left	слева
leg	нога
legal	юридические
leisure	досуг
lemon	лимон
lend	ленд
length	длина
less	меньше
lesson	урок
let	пусть
letter	письмо
level	уровень
library	библиотека
license	лицензия
lie1	лежать
lie2 (tell a lie)	лгать
life	жизнь
lifestyle	образ жизни
lift	подъемник
light (from the sun/a lamp)	свет
light (not heavy)	лёгкий (не тяжёлый)
like (similar)	как; похожий (на)
like (find sb/sth pleasant)	нравиться; любить
likely	скорее всего,
limit	предел
limited	ограниченный
line	линия
link	ссылка
lion	лев
lip	для губ
liquid	жидкость
list	список
listen	прослушать
listener	слушатель
literature	литература
little	маленький
live1	жить
live2	в прямом эфире; живой (не записи)
lively	оживленные
living	жизни
load	загрузить
loan	кредит
local	местные
locate	найдите
located	расположен
location	местоположение
lock	замок
logical	логические
lonely	одинокий
long1	длинный; долгий
long-term	долгосрочный
look	смотреть
loose	потерять
lord	лорд
lose	потерять
loss	потеря
lost	потеряли
lot	много
loud	громко
loudly	громко
love	любовь
low	низкая
lower	нижний; снижать
luck	удача
lucky	лаки
lunch	обед
lung	легких
luxury	роскошь
machine	машина
mad	безумный
magazine	журнал
magic	магия
mail	почта
main	главная
mainly	главным образом
maintain	сохранить
major	основные
majority	большинство
make	сделать
male	мужчины
mall	торговый центр
man	человек
manage	управление
management	управления
manager	менеджер
manner	образом
many	многие
map	карта
March	март
mark	марк
market	рынок
marketing	маркетинг
marriage	брак
married	женат
marry	жениться
mass	масса
massive	массивные
master	мастер
match (contest/correspond)	матч; соответствовать
matching	сопоставление
material	материал
math	математика
mathematics	математика
matter	вопрос
maximum	максимальная
May	мая
may	мая
maybe	может быть
mayor	мэр
me	меня
meal	питание
mean	среднее
meaning	смысл
means	средства
meanwhile	тем временем
measure	мера
measurement	измерение
meat	мясо
media	средства массовой информации
medical	медицинские
medicine	медицина
medium	средний
meet	встретиться
meeting	совещание
melt	расплава
member	член
memory	память
mental	психического
mention	упоминание
menu	меню
mess	беспорядок
message	сообщение
metal	металл
meter	метр
method	метод
middle	средний
midnight	полночь
might	возможно
mild	мягкий
mile	миля
military	военные
milk	молоко
million	млн.
mind	разум
mine (belongs to me)	мой; моя; моё
mine (hole in the ground)	шахта; рудник; мина
mineral	минерал
minimum	минимум
minister	министр
minor	минор
minority	меньшинство
minute1	минута
mirror	зеркало
miss	мисс
missing	отсутствует
mission	миссия; задание
mistake	ошибка
mix	микс
mixed	смешанная
mixture	смесь
model	модель
modern	современные
modify	изменять; модифицировать
mom	мама
moment	момент
Monday	понедельник
money	деньги
monitor	монитор
monkey	обезьяна
month	месяц
mood	настроение
moon	луна
moral	моральная
more	больше
morning	утро
most	большинство
mostly	главным образом
mother	мать
motor	мотор
motorcycle	мотоцикл
mount	гора
mountain	гора
mouse	мышь
mouth	рот
move	перемещение
movement	движение
movie	фильм
much	много
mud	грязи
multiple	множественный; несколько
multiply	умножить
murder	убийство
muscle	мышца
museum	музей
music	музыка
musical	музыкальные
musician	музыкант
must	необходимо
my	мой
myself	сам
mysterious	таинственный
mystery	тайна
nail	гвоздь
name	имя
narrative	повествование; рассказ
narrow	узкий
nation	нация
national	национальные
native	родной; местный
natural	природные
naturally	естественно
nature	природа
near	вблизи
nearly	почти
neat	аккуратно
necessarily	обязательно
necessary	необходимые
neck	шея
need	необходимость
needle	игла
negative	негативные
neighbor	сосед
neighborhood	район; соседство
neither	ни
nerve	нерв
nervous	нервной
net	нетто
network	сеть
never	никогда не
nevertheless	тем не менее
new	новые функции
news	новости
newspaper	газета
next	следующая
next to	рядом с
nice	ницца
night	ночь
nightmare	кошмар
nine	девять
nineteen	девятнадцать
ninety	девяносто
no	нет
no one	никто
nobody	никто не
noise	шум
noisy	шумный
none	нет
nor	и не
normal	нормальный
normally	обычно
north	север
northern	северный
nose	нос
not	не
note	примечание
nothing	ничего не
notice	обратите внимание
notion	понятие; представление
novel	роман
November	ноябрь
now	теперь
nowhere	нигде
nuclear	ядерные
numerous	многочисленный
nurse	медсестра
nut	гайка
obey	повиноваться
object	объект
objective	цель
obligation	обязательство
observation	наблюдение
observe	соблюдайте
obtain	получить
obvious	очевидно
obviously	очевидно, что
occasion	случаю
occasionally	иногда
occur	происходят
ocean	океан
o'clock	час (о времени)
October	октябрь
odd	нечетные
of	из
off	выкл.
offend	обидеть
offense	преступление
offensive	наступление
offer	предложение
office	управление
officer	офицер
official	официальный
often	часто
oh	ох
oil	нефть
OK	хорошо
old	старый
old-fashioned	старомодный
on	на
once	однажды
one	один
onion	лук
online	онлайн
only	только
onto	на
open	открыть
opening	открытие
operate	работают
operation	операция
opinion	мнение
opponent	противник
opportunity	возможность
oppose	против
opposed	против
opposite	обратное
opposition	оппозиция
option	параметр
or	или
orange	оранжевый
order	заказ
ordinary	обычные
organ	орган
organization	организации
organize	организовать
organized	организован
organizer	организатор
origin	происхождение
original	исходный текст
originally	первоначально
other	другие
otherwise	в противном случае
ought	следует; должен (ought to)
our	наши
ours	наша
ourselves	сами
out	выход
outcome	результат; исход
outdoor	открытый
outdoors	на открытом воздухе
outer	наружная
outline	наброски
outside	за пределами
oven	печь
over	над
overall	общая
overseas	за границей; заморский
owe	долг
own	собственный
owner	владелец
pace	темп
pack	пакет
package	пакет
page	страница
pain	боль
painful	болезненные
paint	краска
painter	художник
painting	живопись
pair	пара
palace	дворец
pale	бледный
pan	сковорода
panel	группа
pants	брюки
paper	бумага
paragraph	абзац; параграф
parent	родитель
park	парк
parking	парковка
part	часть
participant	участник
participate	участвовать
particular	особое
particularly	особенно
partly	частично
partner	партнер
party	партия
pass	перевал
passage	проход
passenger	пассажирские
passion	страсть; увлечение
passport	паспорт
past	прошлое
path	путь
patient	пациент
pattern	шаблон
pay	оплатить
payment	оплата
peace	мир
peaceful	мирных
pen	ручка
pencil	карандаш
penny	пенни
people	люди
pepper	перец
per	за
percent	процент
percentage	процент; доля
perfect	идеальный
perfectly	отлично
perform	выполнить
performance	производительность
perhaps	возможно
period	период
permanent	постоянный
permission	разрешение
permit	разрешение
person	лица
personal	личное
personality	личность
personally	лично
perspective	перспектива; точка зрения
persuade	убедить
pet	домашнее животное
phase	фаза
phenomenon	феномен; явление
philosophy	философия
phone	телефон
photo	фото
photograph	фотография
photographer	фотограф
photography	фотография
phrase	фраза
physical	физическая
physics	физика
piano	фортепиано
pick	выбрать
picture	фотография
piece	кусок
pig	свинья
pile	ворс
pilot	пилот
pin	PIN-код
pink	розовый
pipe	труба
pitch	шаг
place	место
plain	равнина
plan	план
plane	самолет
planet	планета
planning	планирование
plant	завод
plastic	пластик
plate	плита
platform	платформа
play	играть
player	игрок
pleasant	достаточно хорошо
please	пожалуйста
pleased	приятно
pleasure	удовольствие
plenty	много
plot	участок
plus1	плюс; знак +
pocket	карман
poem	стихотворение
poet	поэт
poetry	поэзия
point	точки
pointed	указывает
poison	яд
poisonous	ядовитые
police	полиция
policeman	полицейский
policy	политика
polite	вежливо
political	политические
politician	политик
politics	политика
pollution	загрязнение
pool	бассейн
poor	плохое
pop	поп
popular	популярные
popularity	популярность
population	населения
port	порт
portrait	портрет
pose	позы
position	позиция
positive	положительные
possess	обладают
possession	владение
possibility	возможность
possible	возможные
possibly	возможно
post	поместить
poster	плакат; постер
pot	горшок
potato	картофель
potential	потенциал
pound	фунт
pour	налить
poverty	бедность
powder	порошок
power	мощность
powerful	мощный
practical	практические
practice	практика
praise	похвалы
pray	молиться
prayer	молитва
predict	предсказать
prediction	предсказание; прогноз
prefer	предпочитают
pregnant	беременные
preparation	подготовка
prepare	подготовка
prepared	подготовлено
presence	присутствие
present	настоящее время
presentation	презентация
preserve	сохранить
president	президент
press	пресс
pressure	давление
pretend	вид
pretty	милая
prevent	предотвратить
previous	предыдущий
previously	ранее
price	цена
priest	священник
primary	первичный
prime	главный; первичный
prince	принц
princess	принцесса
principal	главный; директор (школы)
principle	принцип
print	печать
printer	принтер
printing	печать
priority	приоритет
prison	тюрьма
prisoner	заключенный
privacy	частная жизнь; конфиденциальность
private	частные
prize	премия
probably	вероятно
problem	проблема
procedure	процедура
process	процесс
produce	продукты
producer	продюсер
product	продукта
production	производство
profession	профессия
professional	профессиональные
professor	профессор
profile	профиль; анкета
profit	прибыль
program	программа
progress	прогресс
project	проект
promise	обещание
promote	содействие
pronounce	произнести
proof	доказательство
proper	правильное
properly	должным образом
property	недвижимость
proposal	предложение
propose	предложить
prospect	проспект
protect	защитить
protection	защита
protest	протест
proud	гордый
prove	доказать
provide	предоставить
psychologist	психолог
psychology	психология
public	общественный
publication	публикации
publish	опубликовать
pull	тяга
punish	наказать
punishment	наказание
purchase	покупка
pure	чистый
purple	фиолетовый
purpose	цель
pursue	продолжить
push	толчок
put	положите
qualification	квалификация
qualified	квалифицированных
qualify	квалификацию
quality	качество
quantity	количество
quarter	квартал
queen	королева
question	вопрос
quick	быстрый
quickly	быстро
quiet	тихий
quietly	тихо
quit	бросить
quite	довольно
quotation	цитата
quote	цитата
race (competition)	гонка; соревнование
race (of people)	раса; этническая группа
racing	гонки
radio	радио
railroad	железная дорога
rain	дождь
raise	поднять
range	диапазон
rank	ранг
rapid	быстрое
rapidly	быстро
rare	редкие
rarely	редко
rate	ставка
rather	скорее
raw	сырье
reach	достижения
react	РЕАКТ
reaction	реакция
read	читать
reader	читатель
reading	чтение
ready	готов
real	реальный
realistic	реалистичные
reality	реальность
realize	реализовать
really	действительно
reason	причина
reasonable	разумные
recall	напомнить
receipt	получение
receive	получить
recent	последние
recently	недавно
reception	прием
recipe	рецепт
recognize	признать
recommend	рекомендовать
recommendation	рекомендация; совет
record	запись
recording	запись
recover	восстановить
recycle	перерабатывать (отходы)
red	красный
reduce	уменьшить
reduction	сокращение
refer	обратитесь
reference	ссылка
reflect	отражать
refrigerator	холодильник
refuse1	отказываться
regard	связи
region	регион
regional	региональные
register	зарегистрироваться
regret	с сожалением
regular	регулярные
regularly	регулярно
regulation	регулирование
reject	отклонить
relate	связаны
related	связанные с
relation	связь
relationship	отношения
relative	относительная
relatively	относительно
relax	расслабиться
relaxed	расслабились
relaxing	расслабляющий
release	релиз
relevant	соответствующие
reliable	надёжный
relief	рельеф
religion	религия
religious	религиозные
rely	положиться
remain	оставаться
remark	замечание
remember	помните
remind	напомнить
remote	удаленный
remove	удалить
rent	аренда
repair	ремонт
repeat	повторите
repeated	повторяется
replace	заменить
reply	ответ
report	отчет
reporter	репортёр; журналист
represent	представляют
representative	представитель
reputation	репутация
request	запрос
require	требуется
requirement	требование
rescue	спасение
research	исследования
researcher	исследователь
reservation	бронирования
reserve	заповедник
resident	-резидентов
resist	сопротивление
resolve	разрешить
resort	курорт
resource	ресурс
respect	уважение
respond	ответить
response	ответ
responsibility	ответственность
responsible	ответственный
rest (remaining part)	остаток; оставшаяся часть
rest (sleep/relax)	отдых; отдыхать
restaurant	ресторан
result	результат
retain	сохранить
retire	на пенсию
retired	в отставке
return	возвращение
reveal	раскрыть
review	обзор
revise	пересмотреть
revolution	революция
reward	вознаграждение
rhythm	ритм
rice	райс
rich	богатые
rid	избавиться от
ride	поездка
right	правильно
ring1	кольцо
ring2	звонить; звон
rise	подъем
risk	риск
river	река
road	дорога
robot	робот
rock (stone)	камень; скала
rock (music)	рок (музыка)
role	роль
roll	рулон
romantic	романтический
roof	крыша
room	номер
root	корень
rope	канат
rough	грубый
round	раунд
route	маршрут
routine	обычные
row1	ряд
royal	королевский
rub	руб.
rubber	резина
rude	грубый
rule	правило
run	запуск
runner	бегун
running	запуск
rural	сельских районах
rush	раш
sad	грустно
sadly	к сожалению
safe	сейф
safety	безопасность
sail	парус
sailing	парусный спорт
sailor	матрос
salad	салат
salary	зарплата
sale	продажа
salt	соль
same	же
sample	пример
sand	песок
sandwich	бутерброд; сэндвич
satellite	спутник
satisfied	удовлетворены
satisfy	удовлетворить
Saturday	суббота
sauce	соус
save	сохранить
saving	сохранение
say	говорят
scale	шкала
scan	сканировать
scared	страшно
scary	страшный
scene	сцена
schedule	расписание
school	школа
science	наука
scientific	научные
scientist	ученый
score	оценка
scream	крик
screen	экран
script	сценарий; рукопись
sculpture	скульптура
sea	мне?
search	поиск
season	сезон
seat	сиденья
second1 (next after the first)	второй
second1 (unit of time)	секунда
secondary	среднее
secret	секрет
secretary	секретарь
section	раздел
sector	сектор
secure	безопасный
security	безопасность
see	см.
seed	семя
seek	искать
seem	похоже
select	выберите
selection	выбор
self	самоуправления
sell	продать
senate	сенат
senator	сенатор
send	отправить
senior	старший
sense	чувство
sensible	разумный
sensitive	чувствительных
sentence	предложение
separate	отдельный
September	сентябрь
sequence	последовательность
series	серия
serious	серьезные
seriously	серьезно
servant	слуга
serve	служить
service	услуги
session	сессия
set (put)	ставить; помещать
set (group)	набор; комплект
setting	обстановка; настройка
settle	урегулировать
seven	семь
seventeen	семнадцать
seventy	семьдесят
several	несколько
severe	тяжелая
sex	секс
sexual	сексуальной
shade	тень
shadow	тень
shake	встряхните
shall	должен
shallow	мелкий
shame	стыд
shape	форма
share	предоставить общий доступ
sharp	шарп
she	она
sheep	овцы
sheet	лист
shelf	полка
shell	оболочка
shelter	жилье
shift	сдвиг
shine	чистка
shiny	блестящие
ship	корабль
shirt	рубашка
shock	шок
shocked	шоке
shoe	чистка обуви
shoot	стрелять
shooting	стрельба
shop	магазин
shopping	шоппинг
short	короткие
shot	выстрел
should	следует
shoulder	плечо
shout	рупор
show	показать
shower	душ
shut	закрыть
shy	застенчивая(ый)
sick	болен
side	сторона
sight	прицел
sign	знак
signal	сигнал
significant	значительные
significantly	значительно
silence	тишина
silent	молчание
silk	шелк
silly	глупо
silver	серебро
similar	аналогичные
similarity	сходство
similarly	аналогичным образом
simple	простой
simply	просто
since	начиная с
sincere	искренне
sing	петь
singer	певица
singing	пение
single	одноместный
sink	раковина
sir	сэр
sister	сестра
sit	сидеть
site	сайт
situation	положение
six	шесть
sixteen	шестнадцать
sixty	шестьдесят
size	размер
ski	лыжа; кататься на лыжах
skiing	лыжный спорт; катание на лыжах
skill	мастерство
skin	кожа
skirt	юбка
sky	небо
slave	раб
sleep	сон
slice	ломтик
slide	слайд
slight	небольшое
slightly	слегка
slip	скольжения
slope	наклон
slow	медленно
slowly	медленно
small	маленький
smart	умный
smartphone	смартфон
smell	запах
smile	улыбка
smoke	дым
smoking	для некурящих
smooth	гладкая
snake	змея
sneaker	кроссовок
snow	снег
so	поэтому
soap	мыло
soccer	футбол
social	социальные
society	общество
sock	носок
soft	мягкий
software	программное обеспечение
soil	почвы
solar	солнечный
soldier	солдат
solid	твердые
solution	решение
solve	решения
some	некоторые
somebody	кто-то
someone	кто-то
something	что-то
sometimes	иногда
somewhat	несколько
somewhere	где-то
son	сын
song	песня
soon	скоро
sorry	извините
sort	сортировка
soul	душа
sound	звук
soup	суп
source	источник
south	южная
southern	южный
space	пространство
speak	говорят
speaker	спикер
special	специальные
specialist	специалист
species	вид (биол.)
specific	конкретные
specifically	специально
speech	речи
speed	скорость
spell	заклинание
spelling	правописание
spend	потратить
spending	расходы; траты
spicy	пряный
spider	паук
spirit	дух
spiritual	духовные
split	сплит
spoken	говорят
sponsor	спонсор; спонсировать
spoon	ложка
sport	спорт
spot	пятно
spread	распространение
spring	весна
square	площадь
stable	конюшня
stadium	стадион
staff	персонал
stage	этап
stair	лестницы
stamp	марка
stand	стенд
standard	стандарт
star	звезда
stare	смотреть
start	начало
state	государство
statement	заявление
station	станция
statistic	статистика; показатель
statue	статуя
status	статус
stay	пребывания
steady	устойчивый
steal	украсть
steel	сталь
steep	крутой
step	шаг
stick (push into/attach)	втыкать; прикреплять
stick (piece of wood)	палка; прутик
sticky	липкие
stiff	жесткая
still	до сих пор
stock	фондовая
stomach	желудок
stone	камень
stop	остановить
store	магазин
storm	шторм
story	история
stove	плита
straight	прямой
strange	странно
stranger	незнакомец
strategy	стратегия
stream	поток
street	улица
strength	прочность
stress	стресс
stretch	растянуть
strict	строгий
strike	забастовка
string	строка
strong	сильный
strongly	сильно
structure	структура
struggle	борьба
student	студент
studio	студия
study	исследование
stuff	материал
stupid	глупо
style	стиль
subject	тема
submit	подавать; представлять (документы)
substance	вещество
subway	метро
succeed	успех
success	успех
successful	успешные
successfully	успешно
such	такие
sudden	внезапное
suddenly	вдруг
suffer	страдают
sugar	сахар
suggest	предложить
suggestion	предложение
suit	костюм
suitable	подходит
sum	сумма
summarize	кратко излагать; подводить итог
summary	резюме
summer	лето
sun	солнце
Sunday	воскресенье
supermarket	супермаркет
supply	поставка
support	поддержка
supporter	сторонник
suppose	предположим, что
sure	уверен
surely	конечно
surface	поверхность
surgery	хирургия; операция
surprise	сюрприз
surprised	удивил
surprising	удивительно
surround	объемного звучания
surrounding	окружающие
survey	опрос
survive	выжить
suspect	подозреваемый
swear	клянусь
sweater	свитер
sweep	развертки
sweet	сладкий
swim	плавать
swimming	плавание
switch	переключатель
symbol	символ
sympathy	сочувствие
symptom	симптом
system	системы
table	таблица
tablet	таблетки
tail	хвост
take	возьмите
tale	сказка; история
talent	талант
talented	талантливый
talk	разговор
tall	талль
tank	танк
tape	лента
target	цель
task	задача
taste	вкус
tax	налог
taxi	такси
tea	чай
teach	учить
teacher	учитель
teaching	обучение
team	команда
tear1	слеза
tear2	рвать; разрывать
technical	технические
technique	техника
technology	технология
teenage	подростковый
teenager	подросток
telephone	телефон
television	телевидение
tell	скажите
temperature	температура
temporary	временные
ten	десять
tend	как правило
tennis	теннис
tent	палатка
term	срок
terrible	страшные
test	тест
text	текст
than	чем
thank	спасибо
thanks	спасибо
that	что
the	определённый артикль (the)
theater	театр
their	их
theirs	их
them	их
theme	тема
themselves	сами
then	затем
theory	теория
therapy	терапия; лечение
there	там
therefore	поэтому
they	они
thick	толстые
thief	вор
thin	тонкий
thing	вещь
think	подумайте
thinking	мышление
third	третий
thirsty	пить
thirteen	тринадцать
thirty	тридцать
this	этот
though	хотя
thought	мысли
thousand	тысяча
threat	угроза
threaten	угрожают
three	три
throat	горло
through	через
throughout	на протяжении
throw	бросать
Thursday	четверг
thus	таким образом
ticket	билет
tie	галстук
tight	туго
till	до сих
time	время
tiny	крошечные
tip	подсказка
tire	шины
tired	устал
title	название
to	кому
today	сегодня
toe	мыс
together	вместе
toilet	туалет
tomato	помидор
tomorrow	завтра
ton	тонн
tone	тон
tongue	язык
tonight	сегодня вечером
too	слишком
tool	инструмент
tooth	зуб
top	вверх
topic	тема
total	итого
totally	полностью
touch	сенсорный
tough	жесткие
tour	тур
tourism	туризм
tourist	турист
toward	на пути к
towel	полотенце
tower	башня
town	город
toy	игрушка
track	трек
trade	торговля
tradition	традиция
traditional	традиционные
traffic	трафик
train	поезд
trainer	тренер
training	обучение
transfer	передача
transform	преобразование
transition	переход
translate	перевести
translation	перевод
transport	транспорт
transportation	транспорт
trash	мусор
travel	путешествия
traveler	путешественник
treat	лечить
treatment	лечение
tree	дерево
trend	тренд
trial	судебное разбирательство
trick	трюк
trip	путешествие
tropical	тропический
trouble	проблемы
truck	грузовик
true	значение true
truly	действительно
trust	доверие
truth	правда
try	попробуйте
T-shirt	футболка
tube	трубка
Tuesday	вторник
tune	мелодия
tunnel	туннель
turn	поворот
TV	ТЕЛЕВИЗОР
twelve	двенадцать
twenty	двадцать
twice	дважды
twin	номер Твин
two	два
type	тип
typical	типичный
typically	обычно
ugly	уродливые
ultimately	в конечном итоге
umbrella	зонтик
unable	не удается
uncle	дядя
uncomfortable	неудобно
unconscious	бессознательное
under	под
underground	метро
understand	понять
understanding	понимание
underwear	нижнее белье
unemployed	безработные
unemployment	уровень безработицы
unexpected	неожиданный
unfair	несправедливо
unfortunately	к сожалению
unhappy	недовольны
uniform	форма
union	союз
unique	уникальный
unit	единица
united	юнайтед
universe	вселенная
university	университет
unknown	неизвестно
unless	если
unlike	в отличие от
unlikely	вряд ли
unnecessary	ненужные
unpleasant	неприятно
until	до
unusual	необычные
up	вверх
update	обновление; обновлять
upon	после
upper	верхняя
upset	расстройство
upstairs	наверх
upward	вверх
urban	цикл
urge	желание
us	нас
use	использование
used1	использованный; подержанный
used2	привыкший (used to)
used to	используется для
useful	полезно
user	пользователь
usual	обычный
usually	обычно
vacation	отдых
valley	долина
valuable	ценный
value	значение
van	ван
variety	разнообразие
various	различные
vary	различаются
vast	подавляющее
vegetable	овощной
vehicle	транспортное средство
venue	место проведения
version	версия
very	очень
via	через
victim	жертва
victory	победа
video	видео
view	вид
viewer	зритель; просмотрщик
village	деревня
violence	насилие
violent	насильственные
virtual	виртуальный
virus	вирус
vision	видение
visit	посетить
visitor	посетитель
visual	визуальный; зрительный
vital	жизненно
vitamin	витамин
voice	голос
volume	объем
volunteer	доброволец; волонтёр
vote	голосование
wage	заработная плата
wait	подождите
waiter	официант
wake	звонок
walk	прогулка
wall	стена
want	хотите
war	война
warm	тепло
warn	предупредить
warning	предупреждение
wash	мойка
washing	мойка
waste	отходы
watch	часы
water	воды
wave	волна
way	путь
we	мы
weak	слабый
weakness	слабость
wealth	богатство
wealthy	богатый
weapon	оружие
wear	износ
weather	погода
web	веб
website	веб-сайт
wedding	свадьба
Wednesday	среда
week	неделя
weekend	выходные
weigh	взвешивание
weight	вес
welcome	добро пожаловать
well	хорошо
west	запад
western	западная
wet	мокрый
what	то, что
whatever	независимо от
wheel	колесо
when	когда
whenever	всякий раз, когда
where	где
whereas	тогда как
wherever	где
whether	ли
which	который
while	во время
whisper	шепот
white	белый
who	кто
whole	целом
whom	кого
whose	чья
why	почему
wide	широкий
widely	широко
wife	жена
wild	дикий
wildlife	дикая природа; дикие животные
will	будет
willing	готовность
win	победа
wind1	ветер
wind2	наматывать; заводить (часы)
window	окно
wine	вина
wing	крыло
winner	победитель
winter	зима
wire	проволока
wise	мудрый
wish	желание
with	с
within	в рамках
without	без
witness	свидетель
woman	женщина
wonder	чудо
wonderful	превосходно
wood	вуд
wooden	деревянные
wool	шерсть
word	слово
work	работа
worker	работник
working	рабочая
world	мир
worldwide	по всему миру
worried	беспокоило
worry	беспокоиться
worse	хуже
worst	наихудших
worth	стоит
would	будет
wound	рана
wow	вау; ух ты
wrap	обертывание
write	написать
writer	писатель
writing	написание
written	автор
wrong	неправильно
yard	двор
yeah	да
year	год
yellow	желтый
yes	да
yesterday	вчера
yet	тем не менее
you	вы
young	молодой
your	ваш
yours	ваш
yourself	себя
youth	молодежь
zero	ноль
zone	зона
